1 13 31
###############################
#p          #                 #
#           #                 #
#   r       #                 #
#           #                 #
#           #                 #
#           #                 #
#           #                 #
#           #                 #
#bfs  bfs   #                 #
#           #                 #
#           #                 #
###############################
